3000000000000000000000000000000000000000000000000000000000000000000000000000000000000000000000000000000000000000000000000000000000000000000000000000000000000000000111111111111111100000000000000000000000000000000000000000000000000000003
3000000000000000000000000000000000000000000000000000000000000000000000000000000000000000000000000000000000000000000000000000000000000000000000000000000000000000000111111111111111100000000000000000000000000000000000000000000000000000003
3000000000000000000000000000000000000000000000000000022222222220000000000000000000000000000000000000000000000000000000000000000000000000000000000000000000000000000111111111111111100000000000000000000000000000000000000000000000000000003
3000000000000000000000000000000000000000000000000000000000000000000000000000000000000000000000000000000000000000000000000000000000000000000000000000000000000000000111111111111111100000000000000000000000000000000000000000000000000000003
3000000000000000000000000000000000000000000000000000000000000000000000000022222222222222000000000000000000000002222222222200000000000000000000000000000000000000000111111111111111100000000000000000000000000000000000000000000000000000003
3000000000000000000000000000000000000000000000000022211111111112222200000001111111111111200000000000000000000000000000000000000000002222222222222000022222200000000111111111111111100000000000000000000000000000000000000000000000000000023
3000000000000000000000000000000000000000000000200011111111111111111120000000000000000000000000000000000000002221111100000000000000000000000000111000211100000000000111111111111111100000000000000000000000000000000222222000000000000000213
3000000000000000000000000000000000000000000000000000000000000000000000002211000000000000000000000022220000000000000001111122222222000000000000000000011100122200000111111111111111100000000000000002222222222222222111111000000000000002113
3000000000000000000000000000000022222200000000000000000000000000000000001100000000000000022222000000000000000000000000000011111111021111110000000000000000111000000011111111111111000000000000000021111111111111111111110000000000000022113
3000000000000000000000000000002211111122200200022211111110000000000000000000000111111111111000000000000000000000000221111111100000000000000000000000000000000000000000000000000000000000022222220000111111111111111111111200000000000211113
3000000000000000000000000022200111111111100000011111111110000000000000000000000000000000000000000000000000000000000000000000000000000000000222000000000000000000000222222222222222220000211111100000000000000000000000000000000000002111113
3000000000000000200220022000000000000000000000011111111110000000000000000000000000000001111111111111111111111110000000000000001110011000000000000000000000010002002111111111111111112200000000000000000000000000000000000000000000021111113
3222222222222000122112211111111111111111111111111111111111100000000000000000000000000000000000000000000000000000000000000001100000000111111111111111111111000000000000011111111111111122111110000000011111111111111111111122222222211111113
3111111111100022111111111111111111111111111111111111111111111111111000000000000000111111111111111000001111111111111111111111000000011111111111111111111111111000001111111111111111111111111111112222211111111111111111111111111111111111113
3111111000001111111111111111111111111111111111111111111111111111111111111111111111111111111111111111111111111111111111111111111000000000000011111111111111111111100001111100000000000000000000001111111111111111111111111111111111100000113
3111111001111111111111111111111111111111111111111111111111111111111111111111111111111111111111111111111111111111111111111111111100000000000111111111111111111111111000000000000000000000000000001111111111111111111111111110000000000000113
3111111111111111111111111111111111111111111111111111111111111111111111111111111111111111111111111111111111111111111111111111111110000000001111111111111111111111111100000000000000000000000000011111111111111111111000000000000000000000113
3111111111111111111111111111111111111111111111111111111111111111111111111111111111111111111111111111111111111111111111111111111111000000011111111111111111111111111111111111111111111111111111111111111111111110000000000000000000000000113
3111111111111111111111111111111111111111111111111111111111111111111111111111111111111111111111111111111111111111111111111111111111111111111111111111111111111111111111111111111111111111111111111111111111111111111111111111111111111111113
3111111111111111111111111111111111111111111111111111111111111111111111111111111111111111111111111111111111111111111111111111111111111111111111111111111111111111111111111111111111111111111111111111111111111111111111111111111111111111113