300000000000000000000000022222222200000000000000000000000000000000000000000000000000000000000000000000000000000000000000000000000000000000000000000000000000000000000000000000000000000000000000000000000000
300000000000000000000000011111111000000000000000000000000000000000000000000000000000000000000000000222222222222222000000000000000000000000000000000000000000000000000000000000000000000000000000000000000000
300000000000000000000000011111110000000000000000000000000000000000000000000000000000000000000000000011111111111110000000000000000000000000000000000000000000000000000000000000000000000000000000000000000000
300000000000000000000000000000000002222222000000000000000000000000000000000000000000000000000000000000000000000000000000000000000000000000000000000000000000000000000000000000022000022000000000000000000000
300000000000000000000000000000000000000000000000000000000000000022222222220000000000000000000000000000000000000000000000000000000000000000000000000000000000000000000222200220011222211220000000000000000000
300000000000000000000000000000000000000000022222000000000000000011111111110000000000000000000000000000000000000000000000000000000000000000000000000000000000000000022111122112211111111112000000000000000000
300000000000000000000000022222222000000000000000000000000000000011111111112000000000000000000000000000000000000000000000000000000000000000000000000000000000000022211100000000000000011111200000000000000000
300000000000000000000000211111111221110000000000000000000000000011111111111000000000000000000000000000002222200002220000000000000000000000000000000000000000000210000002002200022000011111122000000000000000
300000000000000000002222111111111111111111111000000000000000000000000000000000000000000000000000000000200011122001112222222222222000000002020200000200000000222111111000000000000000111111111222000000000000
300000000000000000021111111111111111111111111111200000000000000000000000000000000000000000000000000002100000000000000000000000000000002221212122222122000022111111111000000000000011111111111111220000000000
300000000000000000211111111111111111111111111111122000000000000210000000000000000222222222022002222221111111100000000000000001111222221111111111000000022011111111111111111111000000000111111111112200000000
300000000002220022111111111111111111111111111111111222002022000000001111111222222111111110000021111111111111111000000001111111111111111111111111111100000011111111111111111111111100011111111111111100000000
300000002221112211111111111111111111111111111111111111200011222000011111111111111110000000000011111111111111111220000000000000000111111111111111111111100000011111111111111111111110000000000000000000000000
322222221111111111111111111111111111111111111111111111121211111110111111111111111110001111111111111111111111111111111111111111111111111111111111111111111111111111111111111111111111111111111111111122222222
311111111111111111111111111111111111111111111111111111111111111111111111111111111111111111111111111111111111111111111111111111111111111111111111111111111111111111111111111111111111111111111111111111111111
311111111111111111111111111111111111111111111111111111111111111111111111111111111111111111111111111111111111111111111111111111111111111111111111111111111111111111111111111111111111111111111111111111111111
311111111111111111111111111111111111111111111111111111111111111111111111111111111111111111111111111111111111111111111111111111111111111111111111111111111111111111111111111111111111111111111111111111111111
311111111111111111111111111111111111111111111111111111111111111111111111111111111111111111111111111111111111111111111111111111111111111111111111111111111111111111111111111111111111111111111111111111111111
311111111111111111111111111111111111111111111111111111111111111111111111111111111111111111111111111111111111111111111111111111111111111111111111111111111111111111111111111111111111111111111111111111111111

